111111111111111111111111111
1E0000000000000C00000C00011
101001010010000010100100001
101001001000010000100100001
1P0000000C00C0C000000000001
111111111111111111111111111
