111111111111111111111111111
1E0000000000000C00000C00001
101001010010000010100100001
101001001010101000100100001
1P0000000C00C00000000000001
11111111111