111111111111
100C000001E1
1P0011100C01
111111111111

