111111111111
101P000001E1
11101110C001
111111111111

